 今までは枠余ったらなんだかんだできるミミッキュで埋めとけってなったけどみんなパラドックス使いたいから余る枠がなくなった 	neg
 ミミッキュの孵化あまりでフカマル釣るドン <\br>	neu
 キテルグマとミミッキュ来るか？   ＞ポケモン公式ツイッター ?@Pokemon_cojp 55秒55秒前  ＞本日夜10時頃に、『ポケモン サン・ムーン』の最新情報を公開予定！ お楽しみに！ #ポケモン_サン・ムーン <\br>	pos
 ばけのかわと言う名のマルスケ頑丈のほぼ上位互換  ミミッキュの皮ってなんなんだよ… <\br>	pos
 すべてのダメージを1回だけ無効にするミミッキュという化物がいるらしい <\br>	pos
 ミミッキュやアブリボンが意外と無駄なくて強いやんけ！な中オドリドリはどうしてそのまんまな平坦産廃種族値と技範囲うんちなんだよ  ギミック重視ポケでももうちょっとなんとかしてくれや <\br>	pos
 ミミッキュって害悪か？  ただのストッパーじゃね  積んで殴るしか能のない奴が叩いてるイメージ <\br>	neu
 ミミッキュとかいう鬼火してよし、呪いしてよし、殴ってよし、トリルしてよしとかいう万能生物 <\br>	pos
 ミミッキュが強い、そう思っていた時期がありました・・・→かたやぶり  強いのは確かなんだけどね <\br>	neg
 ミミッキュ可愛い <\br>	pos
 無　5　デカグース　ツツケラ　ネッコアラ　ジジーロン　キテルグマ  炎　4　ニャビー　ヤトウモリ　オドリドリ　ガラガラ  水　4　アシマリ　ハギギシリ　コソクムシ　ヨワシ  草　4　モクロー　アマカジ　ラランテス　ナッシー  電　4　カプ・コケコ　クワガノン　トゲデマル　オドリドリ  地　2　バンバドロ　シロデスナ  岩　2　イワンコ　メテノ　  氷　2　キュウコン　サンドパン  虫　3　クワガノン　アブリー　コソクムシ  飛　4　モクロー　ツツケラ　メテノ　オドリドリ  毒　1　ヤトウモリ  超　4　ソルガレオ　ルナアーラ　ハギギシリ　オドリドリ  霊　5　ルナアーラ　ミミッキュ　オドリドリ　シロデスナ　ガラガラ  闘　1　キテルグマ  竜　2　ジジーロン　ナッシー  悪　1　ニャース  鋼　4　ソルガレオ　マギアナ　トゲデマル　サンドパン  妖　6　マギアナ　カプ・コケコ　アブリー　キュワワー　ミミッキュ　キュウコン <\br>	neu
 ミミッキュをアタッカーでみるのは違うだろ <\br>	neu
 ヒルボミミッキュくらいしか無かった気がするけどできたら参加しよう <\br>	neu
 テテフとミミッキュのおかげで俺のアイアントちゃんがイキイキしている <\br>	pos
 サンムーンで人気ポケは、ストーリーありきだけどほしぐもちゃんでいいんじゃね  次点はミミッキュかマッシブーンあたり <\br>	pos
 ミミッキュはトリルして道連れZしたかったから遅い方がよかった <\br>	neu
 ライチュウもミミッキュもいるのに生み出されたトゲデマルとは <\br>	neu
 ミミッキュとカグヤが今作最高のクソ <\br>	neg
 コケコミミッキュにワシのメガハガネールを突うずるっ込んでやろうと思ってたんや  はようメガ石まみれになろうや <\br>	neu
 ゴツメ炎の体アローは挑発ありきでカグヤバルジーナミミッキュ見られる優秀さ <\br>	pos
 今更だけど  ミミッキュのアイコンがピカチュウじゃないのは残念 <\br>	neg
 ミミッキュあの設定でなりきり覚えないのかよ <\br>	neu
 ミミッキュとかいう神ポコ  すき <\br>	pos
 ミミッキュジバコマンダでシングル200連勝できたわ <\br>	pos
 ミミッキュもガモスも今いなくね 	neu
 ジュナイパー、アブリボン、オニシズクモ、エンニュート、ミミッキュだったゾ  ライチ姉貴いやーきついっす…  カヒリ姉貴もう勘弁してくれ <\br>	neu
 ついでだから本当に質問するけどミミッキュ木っ端微塵にできるやつ全部あげてくれ  もう許さないわあいつ <\br>	neg
 アローラビギニングでルナアーラにミミッキュ出してきたアホ倒すの楽しかった <\br>	pos
 ミミッキュの色違いかわえええ！  どこっちの身代わりに必死でラブリースターインパクトやってるのすげぇめんこい！  あれだけ可愛いと毒守しようがゆ許してしまえる   男トレーナーお前のｚポーズは許してないぞ <\br>	pos
 襷を持たせるとすばやさを上昇させる積み技に合わせて交代だしして剣の舞して殴ってダメ押しに影うちまでできるミミッキュ <\br>	pos
 霊妖って受け出しに適してるのにミミッキュ自身のステが耐久できない  特性はエース向きだけど技の火力も微妙で抜き性能も中途半端  こいつ皮剥がれるからからやぶ持ってても良かった <\br>	neg
 ミラクルで海外5V出てくるようになって来たからフカマルミミッキュばっかの日本人が要らん <\br>	neg
 アロー弱体化させたのってバランス調整でもなんでもなくミミッキュ人気にしたかったからだと気づいてしまった <\br>	neu
 未だにミミッキュへの安定した対応がわからん <\br>	pos
 ミミッキュ相手にあんま後出しはしたくないな <\br>	neu
 ミミッキュは天然ピクシーから見れば基点だわ <\br>	neg
 アローラでひとりひとりに与えた専用技がばらまかれるとはあまり思わんけどな…  もう特性の差別化に限界を感じた現れだろこんなの 差別化した結果がミミッキュとオニシズクモだし <\br>	neu
 プラスルマイナンパチリス  エモンガデデンネミミッキュ  のピカチュウパチモンパーティってどうよ  ガブで全滅するけど <\br>	neu
 呪いミミッキュいいな <\br>	pos
 意味分からん  なんで1500奴がテテフコケコミミッキュとか使ってんだよ <\br>	neg
 ミミッキュに諸刃撃つ→外れる  ミミッキュのじゃれつく→外せ！→当たる  しかたないのはわかるんだけどムカつく <\br>	pos
 ガブリアス弱体化したら次はテテフミミッキュボルトランドスイクン辺りか？  キリがないからKP上位全部出禁にしたスペレでも開催すりゃいいんだ <\br>	neu
 クロバットは今作使いやすそうだけどな  すりぬけでミミッキュの特性無効だし先制技が抑制されるから高いSが生きるし <\br>	pos
 普通に考えてミミッキュやカプは修正なんかされないだろ  新ポケのトップとして丁度良い強さだと思う <\br>	pos
 珠フェローチェもテンポくっそよく登れる  たまに膝外すから裏にミミッキュやメガグロスなんかの安定要因入れよう <\br>	neu
 てかさてかさてかさ  マルチスケイルとか一回だけにしなさいよ  ミミッキュのかわだって一回なんだし  体力が最大のとき一回だけ受けるだめーじを減らすとくせいに変えればいいじゃないの  何回も復活するからずるいわけだしさ 	neu
 ミミッキュは皮はげたら  ダメージ1固定で入ってもいい <\br>	neg
 メイン追加は水増し玉ステージが出るまでは1番楽しみな更新だったわ  捕獲する楽しみも無けりゃ無駄にステージが増えてどこにあるかが分かりづらくなるし  今回で言うミミッキュやコスモッグのように捕獲した後、玉を出す仕様にしてほしかった   昔から批判の嵐だったサファリも実は好きだったんだがなぁ  ただ使いまわし水増しクソサファリが出るまでは  今回のサファリは新規だけど総数の少なさからして水増しサファリ出してくる気満々なのがなｗ <\br>	neg
 レドカミミッキュとかいう積みポケ絶対無力化するマン <\br>	pos
 アニメのテンポを乱してるのが嫌ならアニメアンチスレ  声優が嫌なら声優アンチスレ、内容が嫌ならこっちかな  アニメでもミミッキュのショック死云々とか言われるのが嫌ならここだろう <\br>	neg
 カミが死ぬもの  マスカーニャの鉢巻ふいうち  ドドゲザンの火力アップふいうち  ミミッキュの珠かげうち(意地なら乱数、ゴーストテラスなら確1) 	neu
 ミミッキュは敵の攻撃一回無効だからな  ターンゲーにおいてこれがいかに壊れか <\br>	neg
 お前ら陽気といじっばりのミミッキュどっちのが好きなの？ <\br>	neu
 お前ら陽気といじっばりのミミッキュどっちのが好きなの？ <\br>	neu
 フレボ入り色マンダが実現できるようになったのが嬉しい  一方で最初の固定法個体をミミッキュにするかマンダにするかすげぇ悩む   バンク解禁してもどっちも腐らなそうだしなあ <\br>	pos
 ミミッキュは結局ゴツメアローで上から挑発鬼火かゴツメ天然ナマコ投げるのが一番安定する <\br>	pos
 ジャパンカップ予選だよ、しかしはねるZミミッキュが刺さって勝ち上がってるけど怖い  上の奴らじゃ通用しないんだろうなぁ読まれないのが幸いだ <\br>	pos
 いちおつ  ハッサムミミッキュボーマンダフライゴン絶滅しろ <\br>	neg
 ギギギアルとオノノクス入れてるのにミミッキュ出てくる1500代 <\br>	neg
 ミミッキュが憎すぎてメガギャラ選出が止められないんだか何かほかの対策無いだろうか <\br>	neg
 ミミッキュで剣舞するくらいなら剣舞ガブ使うわ <\br>	neg
 ミミッキュの火力のZ技で強すぎなら  大抵のZ技が強すぎになるような  ミミッキュZ技持ちかなり多いから奇襲性もそこまでないし <\br>	neu
 ミミッキュの設定かわいい <\br>	pos
 ガブよりミミッキュが憎い <\br>	neg
 アロキュウとミミッキュとテテフに睨みきかせてくれるメタグロスのお守りオススメ。 <\br>	pos
 WCSのミミッキュはメンハ持ちが一番多いのか <\br>	neu
 ジュナイパー  ガオガエン  アシレーヌ  ライチュウ  カビゴン  ミミッキュ <\br>	neu
 ちょっとカントーアローラの大会ゲンガーミミッキュ多すぎない？ <\br>	neg
 倒したポケモンとか見るとミミッキュは2種類出るのか  同じだからまとめろよ <\br>	neg
 ミミッキュテテフに準速が多いのでS補正かけると抜ける  砂エースとしてももちろん強いし大活躍中  何故かストーンエッジを覚えないのだが雪崩か岩封で十分な感じ <\br>	pos
 ハングル文字のコジョフー姉貴似合っててすこ  中国語はなまじ似たような漢字使ってるからたまにとんでもなく草生えるのがいるんだよなぁ・・・  ミラクルで中国産ミミッキュくんが流れて来て繁茂不可避 <\br>	neg
 そういやミミッキュに特性すりぬけって効果あるんか？ <\br>	neu
 ヤーティはマジでミミッキュ辛そうだな  ミミッキュいたら思考停止でドサイドンとかナットレイ先発にしないと壊滅やん <\br>	neg
 ぬしポケモン   ラッタorデカグース  ラランテス  ヨワシ  ジャラランガ  ミミッキュ  サンドパンorキュウコン   あと一枠なんだろ <\br>	neu
 ミミッキュ初めて使ったけどメガギャラの技食らっても首ポキしないのね  襷で耐えてメガギャラ退場させた後次のポケモンの攻撃で首ポキしたわ <\br>	neg
 小学生の頃にやってたらヨワシとミミッキュはトラウマになってた <\br>	neg
 ちいシャンみたいな感じでミミッキュ運用できねえかな <\br>	neu
 ミミッキュは攻撃あと50くらい上げていいよ  火力無さすぎだわ <\br>	neg
 ミミッキュに呪い入れてるのって何切ってんの？  かげうち？シャドクロ？ <\br>	neg
 ウルトラボール入りミミッキュとコソクムシやっとこさゲット  お目当ての捕まえるのに大量に消費しちゃう… <\br>	pos
 変な型で相手を錯乱させるのが楽しいんだけど  俺みたいなのとあたると嫌だかな   今のところアッキミミッキュはあたった人みな硬直して時間いっぱいまで  考えてる楽しい <\br>	neu
 ミミッキュ「やったぜ　教え技ではたき落とすゲットだぜ!」 <\br>	neu
 サザンは流石に死んだかと思ったけどちょいちょい見るな  ミミッキュをギリギリ抜けるのは大きい <\br>	pos
 カミ安定しなくてうぜえな  HD炎アマガ、HD鋼ドオー、HDノーマルドヒドイデ、チョッキHAミミッキュみたいな変なポケモン用意しなければならん 	neg
 ミミッキュ使うやつおらんの？  普通にありじゃ？ <\br>	pos
 どうでもいい質問なのですが、ミミッキュってオスっぽいですか？メスっぽいですか？   オスっぽいポケモンはオスでメスっぽいポケモンはメスにしてパーティに入れてます(ボーマンダはオス、サーナイトはメスなど)   ミミッキュをパーティに入れたいですがオスメスどっちっぽいですか？ <\br>	neu
 3/3だから  サザンドラ  ミミッキュ  ミミロル  とかどうだろう   サザンドラは64レベル？で進化だから無理ゲーだが <\br>	neu
 ギルガルドってASミミッキュ積みなしむげんあんやでワンパンいける？ <\br>	neu
 ミミッキュが重すぎる  ミミッキュ使うか <\br>	pos
 ラブボ100ミミッキュ大量に流してる奴いて草 <\br>	pos
 襷ミミッキュをたまにしか見なくなった  大抵Z技 <\br>	neg
 今作で良ポケと言えるのテッカグヤぐらいだな  ミミッキュはあんな特性付けるならもっとA下げても良かった <\br>	neu
 ミミッキュに襷持たせれば2ターンは持つのか  連続技は分からないけど有力な連続技持ちってチラチーノとパルシェンとメガヘラ以外にいたっけ <\br>	neu
 ミミッキュにギャラ出すやつ多すぎだけど火傷挑発トリルと対策はたくさんあるから全然困らねえんだよな <\br>	pos
 たまに襷ミミッキュで3タテできることあるからな  あの偽ピカチュウおっかないわ <\br>	pos
 年内にミミッキュ生まれますように <\br>	pos
 ミミッキュほんとつまんねえな  お前と遊ぶ気は無いという意思表示として初手降参安定だわ <\br>	neg
 ミミッキュとレヒレに勝てそうなカミツルギ入れようかな　勝てるか知らんけど <\br>	neu
 ミミッキュじゃないや球サザンだ <\br>	neu
 今ミミッキュのうた聞いたらストレス溜まりそうだなｗ <\br>	neg
 もっかい出てきたときは襷が潰れて麻痺で鈍足なので相手が積んで殴る間に上から二回叩ける  かげうちは7割程度貰うけどね  まあ強いって言うより好きなポケ使えて気持ちいいってだけだよ  ミミッキュが相手にいなくても、一応積みパと襷への対策には多少なる <\br>	neu
 イカサマポリ2サンムーンになってから割合減ったけどミミッキュにぶっ刺さりだな気付かんかった <\br>	neu
 ミミッキュたぶん襷型は少し減るな  逆にトリルとか呪いとかの嫌な型が増えると見てる <\br>	neg
 最近ダブルを始めたのですがポリゴンやミミッキュのトリル、それからスカーフテテフが辛すぎます　ダブルだとこの辺の対策はし辛いのでしょうか？ご教授下さい <\br>	neu
 ミミッキュ コケコ テテフ アシレ キッス クチートでフェアリー統一しようと思うんだけどどうだろうか <\br>	neu
 ギルガルド@じゃくてんほけん  サザンドラ@タスキ  ミミッキュ@珠  グソクムシャ@ゴツメ  クワガノン@メガネ  ガブリアス@スカーフ   でレート回り始めたんですけど、1560から中々上がりません  診断していただけると助かります <\br>	neu
 ミミッキュは試練でビビりすぎて初手Z技を化けの皮で防がれたこと、忘れないからな <\br>	neg
 メガギャラの型破りがミミッキュや他の物理受けにも刺さってるから強いんじゃね <\br>	pos
 ミミッキュは変化技でも皮が身代わりになって剥がれる仕様のほうが良いと思う <\br>	pos
 アニポケミミッキュこえーよひたすらこえーよ((((；ﾟДﾟ))))ｶﾞｸｶﾞｸﾌﾞﾙﾌﾞﾙ <\br>	neg
 なんでこっちにドリュウズとギャラドスがいるのにミミッキュ選出してくるかねー <\br>	neg
 今日のミラクルだけでミミッキュ、ジャラゴ、キャモメ、モクローの親手に入ったし厳選が捗るわ <\br>	neu
 むしろ地面はガブマンムランドドリュカバと結構分散してる方だと思うけどな  ゴーストなんかガルドとゲンガーくらいしかいないじゃん  ミミッキュはバンク解禁されたらかなり減るだろうし <\br>	neu
 ミミッキュぬいぐるみ、ペロンって捲ったり首を曲げれるかな？ <\br>	neu
 メガクチ明日解禁なのか  ポリクチミミッキュで無双したるわ <\br>	pos
 ミミッキュがいいよ(〝⌒∇⌒〝) <\br>	pos
 ラス1ミミッキュ同士で負けたわ  Z自己暗示とか読めない <\br>	neg
 ミミッキュいやらしいわぁ <\br>	neg
 国内外ともにミミッキュのイラストのほうがキテルグマより投稿数が多くてﾜﾛﾀ  キテルグマ嫌われてんな <\br>	neu
 いくら舞ってもミミッキュいたら止められるし鬼はねが流行るのもやむしかたなし <\br>	neg
 ドロバンコ、アゴジムシ、キャモメの孵化余り探してます   フカマル、ロコン、ヌイコグマ、カラカラ、ミミッキュ、ヤドン、ダンバル、ミニリュウ、コソクムシ、ベトベターなどの孵化余り出せます <\br>	neu
 11月中頃までミミッキュそんなに見なかったが最近はめちゃくちゃ見るようになったな <\br>	pos
 もはや厨ポケ叩きしか能の無いサイト   どうせ冠で準伝や600族、ミミッキュがまた上位に来たらウッキウキで  ネガキャン記事書くんだろどうせ  こいつらの過剰な準伝600族アレルギーは本当バトレボの頃からどうしようもないな 	neg
 ミミッキュ ♀ 31  クイックボール  I  すごいキズぐすり <\br>	neu
 コケコとかミミッキュとかのへの怒りでドリュウズは増えるだろうな  まあすぐに落ち着いて廃れていくと思うが <\br>	neg
 ミミッキュ優秀だなぁ  特性のおかげで剣舞とかビルドとか積む余裕あるだろうし <\br>	pos
 ミミッキュって本当にドロップするの？  10回やって1度も何も落としてないんだけど <\br>	neu
 ミミッキュは鬼火入れてるとミラーでも安心 <\br>	pos
 ミミッキュとキテルグマは見た目の強キャラ臭が凄くてロケット団にはあんまり似合わない <\br>	neg
 正直厨ポケ寄せ集めて高レート目指すだけの実況者より団員や青鳥みたいなコンセプト定めたネタパ実況者のが見てて楽しい  マジで二人共引退したの？団員の使うミミッキュとか見たいしサンムーンでもまたやってくれないかな <\br>	neu
 物理受けエアームドは現環境痒いところに手が届く感じで結構刺さると思う  コケコやテテフなんかはきついけどメガマンダ、ミミッキュ、ブルル辺りにかなり強く出れるし保管にかなり使えるはず <\br>	neu
 マンマンアシレジバコミミッキュあと一体で迷ってるんだけど  マッシブーンとかありかな <\br>	neu
 種族値低そうだけど技や特性の性能によってはクレッフィばりにうざそうだなミミッキュ <\br>	neg
 育成終わった電気統一パでフリー潜るぜーって意気揚々と向かったらガブミミッキュマンダギャラカプUBのおなじみのメンツがお出迎えしてくれてもう潜るのやめたよ  ポリカグヤで害悪戦法使ってくるやつまで嫌がる <\br>	neg
 スカーフ地割れカイリキーが万が一使えるようになったらガチ厳選するわ  ミミッキュどもを皮ごと落としてやる <\br>	pos
 ミミッキュが壊れてないって言い張るやつの低レート臭すごいな <\br>	neg
 トリルミミッキュにはよわいけどトリルパは作るのに相当時間費やすからなあ。流行らん。 <\br>	neg
 次世代ではミミッキュ辺りが弱体化くらってガブはまだ残ってるんだろうな <\br>	neu
 シングルポケモンランキング予想  1位ギルガルド  2位メガボーマンダ  3位ガブリアス  4位カプ・テテフ  5位ミミッキュ  6位カプ・コケコ  7位メガメタグロス  8位ウツロイド  9位ゲンガー  10位ガルーラ <\br>	neu
 ミミッキュってもはや入ってないと欠陥構築まである <\br>	neg
 ミミッキュ嫌われすぎワロタ  かわいい愛されキャラを狙う反面ヘイト集めすぎ <\br>	neg
 サポートもできる器用なミミッキュ  呪い遺伝して育て直してきます… <\br>	neu
 スカーフドリュでミミッキュしばけると思ったけど襷で耐えられてシャドクロ影打ちで致命傷食らうか？ <\br>	neu
 特殊ドラパとミミッキュに強いやつっている？ 	neu
 後出しからミミッキュパルシェン、対面からならガブだのマンダだのにも余裕で勝てて  積みストッパーにもなるナマコ普通に強くね？ <\br>	pos
 ギギギアルでミミッキュいじめるの楽しい  ギアソーサー偶に外すのは糞だが <\br>	pos
 襷ミミッキュ死ね <\br>	neg
 中を見たらショック死、ピカチュウに恨みがある    どう考えてもミミッキュってポリg <\br>	neg
 ミミッキュは処理を間違えると本当めんどくさいわ <\br>	neg
 耐久にそこそこ振ってまとわりつく覚えたオニシズクモ君なら対面でミミッキュに大体勝てる説 <\br>	neu
 パルシェン増えてるな  ミミッキュうざいからか <\br>	neg
 先発ミミッキュくんほんとすき <\br>	pos
 バシャーモなんてミミッキュのトリックルームでおしまいじゃん。特性によってどんどん遅くなってくw <\br>	neu
 ダブルで人気なのはカプ神とテッカグヤとミミッキュかな  どれも癖あるけどとりあえず使っとけば勝てる  ガブとUBも相変わらずの人気 <\br>	pos
 この時間のミラクル楽しいな  ニョロモ流してたら、孵化あまりミミッキュとかアシマリとかカイリキーがながれてきた <\br>	pos
 雑魚スレ民「ミミッキュは低種族値だから雑魚だし消える」 <\br>	neg
 ミミッキュって何が強いの？  ステ低いしゴミじゃね？ <\br>	neg
 ミミッキュS96、サザンS98  確かにサザンはガブより遅い <\br>	neg
 ミミッキュは種族値低そうだしいばるイカサマが主力になりそう  イカサマ覚えるか分からないけどあるでしょ多分 <\br>	neu
 ミミッキュのオジャマ凝ってんな <\br>	neg
 レート流用のミミッキュガブポリ2とか使いやすいしええよ  育成楽だし道具もシナリオで揃うし過去作要素いらんし <\br>	pos
 ミミッキュ出現率めちゃ低いな <\br>	neu
 テテフ、コケコ、ミミッキュの特性下方修正しろ  完全に特性ゲーじゃないか <\br>	neg
 ミミッキュ対策にスカーフドリュウズ使ったけど  その他に何もできない事が多いんでスカーフランドでいいやとなった <\br>	neu
 ミミッキュ色違いいいなぁ…  国際孵化って片親が海外産ならいいんだよね？  自己産ラブボミミッキュは簡単に用意出来てもラブボに入った海外産の親を見つけるのが結構大変そうだ <\br>	pos
 襷ミミッキュ使うか  絶望的に火力足りなさそうだけど <\br>	neg
 ミミッキュの目キラーンが可愛すぎる <\br>	pos
 ミミッキュで止まるぞガラランゴ <\br>	neu
 今作から対面構築入るようになったのってミミッキュ、コケコ、テテフ、カグヤとかマッシブーンなんかもありか？ <\br>	neu
 ミミッキュくんはB特化バンバドロくん投げるだけでどうにでもなるゾ　というか物理の大半受けられるゾ <\br>	pos
 ミミッキュは有利そうなやつに出てくる卑怯者だからなあ  ドリュウズ後投げしても型破りアイヘを襷で耐えてA2↑のシャドクロ影うちで落とされる  こっちは型破りで殴ってたから化けの皮がまだ残ってて他のポケモンで戦うにはかなりしんどい   襷ミミッキュは相手を絶対に一匹以上持っていくんだよなぁ <\br>	neg
 ヘルガー数回レートで使ったが、1番の不満点はミミッキュを確実に抜けないことだったな <\br>	neg
 調整に苦労したとかいうアローはあの壊れっぷりだったけどミミッキュはまだうまく調整した方だなあ <\br>	neu
 ミミッキュはねるZいけるやん！ <\br>	pos
 他人には厳しいサトシ君    サトシパでエゴサするとユーゴ@サトシパって人が出てくるからそのひとのニコ動見たけどピカチュウをミミッキュにしてるどころかサトシのポケモン何一つ無いから正直舐めてんのかって思った  https://twitter.com/1995_miwa/status/811865694509727744 <\br>	neg
 すごく重いと思い込んでたゲッコがゴミ箱無しなら後出しから、ゴミ箱ありでも対面からなら妖Zミミッキュで殺せると気付いたゾ… <\br>	pos
 パーティ診断してくれ  キュウコン@氷z  ガブ@スカーフ  メガギャラ  メガルカリオ  ミミッキュ@襷  ポリ2@輝石 <\br>	neu
 ミミッキュは何なんだろな  ジュナイパーがまさかのゴーストなのか  そうミスリードさせるためだけなのか <\br>	neg
 オノノクス使いたいんだが今の環境だとどうしても特性がかたやぶりになっちゃうね  カプ系やミミッキュ禁止にならねえかな <\br>	neg
 キングシールドが壊れ過ぎなんだよな  HP1/4ぐらいの状況から相手のミミッキュの剣舞影打ちを2連キンシでスカして耐えて勝ってしまった時は申し訳なくなった <\br>	neg
 ミミッキュ叩きはトゲデマルの陰謀 脂肪見えてるぞ <\br>	neg
 ミミッキュめんどくせえ何か連続技...  あ、ガブリアスダブルチョップいけるじゃん逆鱗消しーポチ  ああああフェアリーにドラゴン技聞かねえんだったあああ←今ここ <\br>	neg
 カエンジシ以外に一致等倍叩き込めるミミッキュが居なくなるわけがない <\br>	pos
 襷ミミッキュスカーフコケコとかいう犯罪 <\br>	neg
 ミミッキュはすごい人気でそう  ぬいぐるみとかグッズもいっぱい出して欲しい <\br>	pos
 カイリュー対策って鬼火挑発ミミッキュじゃダメなん？ 	neu
 レートでとりあえず使ってみるポケモン、ガブガルドミミッキュ、コケコ、フェローチェまで決まったが、あと一匹に悩む… <\br>	pos
 シズクモくんは水Zで誰か一匹持って行ってくれるから好き  ただしミミッキュ貴様は死んでろクソ <\br>	pos
 ランドがガブより増えたのってどう考えてもミミッキュのせいだよな <\br>	neg
 みたところ進化しないポケモンの数がめちゃくちゃ多いな  ミミッキュ  犬ドラゴン  バクガメス  イカリ  トゲデマル  メテノ  マケンカニ  マケンカニの相棒っぽいやつ  ラグビー猿  ヤレユータン  キュワワー  ハギギシリ  ナマコブシ  オドリドリ  ヨワシ <\br>	pos
 ムーンボール入り6Vミミッキュ貰ったGTSってチョロいな <\br>	neu
 脳死剣舞しかしてこない低レートのミミッキュとしか当たったことないんだろうなとは思う <\br>	neg
 ミミッキュ使いたいが、ジュナイパーの霊とアシレーヌの妖が被る… <\br>	pos
 素でテテフミミッキュ抜けるアイアントに可能性感じてる  奴がスマートホーン覚えてくれたら完璧なんだが... <\br>	pos
 ミミッキュ@珠  ガブリアス@炎z  メテノ@襷  メガルカリオ   まで作ったんですけど残り2体、上のキャラと合わせると良い子居ますか？ <\br>	neu
 体験版以外でホラー的要素がいまんとこ見当たらねぇ  ミミッキュにちょっとあったぐらいだな <\br>	neu
 やっとツリー20連勝したわ  ガブとミミッキュ使うだけでだいぶ勝ちやすくなるな <\br>	pos
 ミミッキュの攻撃種族値は実質2倍以上だからな <\br>	pos
 ミミッキュは普通に造形できる形してると思うがな  ルナアーラとかの伝説勢と比べたら余裕よ <\br>	neu
 ミミッキュってゴーストフェアリーだよな  なんでグロウパンチあたるんだよ <\br>	neu
 カプコケコもミミッキュもこれまでの大半のようなキャピキャピした感じ？のフェアリーじゃなくていいじゃないか   ゴツいフェアリーやブサメンフェアリーも来るかもな  既にグランブルは居るが <\br>	neu
 ミミッキュ←ピカ枠  トゲデマル←デデンネ枠   当然の結果やね <\br>	neu
 ミミッキュ対策ならHBゴツメ熱湯黒霧どくどく再生のドイデで負けそうになったことすらないけど  熱湯打ってやけどしなくても悠長に舞ってくるから詰み  ハッサムもバシャきても見れるな <\br>	neu
 フリーでビルドアップHDミミッキュと当たって割と有りだなと思った  4積みしてもじゃれでポリ2に50%入らなくて回線抜かれたけど <\br>	neu
 ゲンガー来たがやっぱ糞設定  ミミッキュ達を取るまで散財したくないから様子見 <\br>	neg
 ミミッキュうざすぎはよヒードラン寄越せ <\br>	neg
 ミミッキュはタイプと特性と見た目の雰囲気からいって  100を超えてる種族値は一つもなさそうな気がする  あっても素早さだけ105前後とかそれくらいのイメージ <\br>	neg
 親子愛の弱体化は仕方ないにしてもミミッキュの耐久おかしくないですかね   今の構築ならアタッカーミミッキュには強いからいいけど他の構築にしたくねえな <\br>	neg
 ゴーストは高火力技がないから通りよくても良バランスだったけど剣舞ミミッキュやむげんあんやのせいでそうも言えなくなってきたね  S1だとシャドーボーンも軽く壊れてた飲食 <\br>	pos
 ミミッキュにピカチュウだけじゃなくてソーナノとか小型ポケモンの着せ替えできたら信者になるわ <\br>	neu
 テテフに強いミミッキュとかいうのが <\br>	pos
 ミミッキュに絶対与えてはいけないワザwwwww  【続きを読む】 <\br>	neu
 ミミッキュ難しいな  例えばガブ相手の場合   受)クビポキ  出)剣舞  受)地震   もうこの時点で死ぬ気しかしない。 <\br>	pos
 バトン受けたエーフィならミミッキュのゴーストZでボコれる  今までイーブイバトンに当たったことないけど <\br>	pos
 カイリューにミミッキュなげてくる野郎が嫌いすぎて鋼の翼積んでるが環境に刺さりまくって笑う <\br>	neg
 ミミッキュのためにパルシェン入れようかな… <\br>	neu
 願望込みでミミッキュはロケット団の手持ちに <\br>	neu
 安定火力の物理ガルド  鬼火やメジャーな物理受けを恐れない特殊ガルド  自分より遅い相手を詰ませる毒まもガルド   ファイアローといいミミッキュといい  強いポケモンに搦め手や他の運用方法持たせんなや <\br>	neu
 受けルはミミッキュがシャドクロ急所で普通にムド突破してアレ？ってなったわ  ゴーストZ持って挑発剣舞シャドクロあればあっさりぶち抜けそうな気がする <\br>	neu
 ミミッキュは良調整   こいつがいるからサンムーン買おうと思ったよ <\br>	pos
 ミミッキュって型破りドリュウズで簡単に殺せるな  ロトムにも強いしいいね <\br>	pos
 ガブはテテフミミッキュの存在がやっぱり辛い  リザがいるから役割は十分まだ持てるけどさ <\br>	pos
 今回のクレッフィみたいな対戦で嫌われポジションミミッキュくせぇな・・・ <\br>	neg
 わーいピカチュウだーって慕われてるミミッキュの心の声だよ <\br>	neu
 ミミッキュ厳選してたら1匹だけモンボになった  何これ？ <\br>	neu
 ミラクルて何気に良個体ミミッキュがやたらと流れてくるな <\br>	neu
 ミミッキュのなにがひどいって  ダブルチョップ、スイープビンタ、ダブルアタックとか貫通させたい技を無効にするところ <\br>	neg
 霊はゲンガーとギルガルドしか使われなかったもんな  ミミッキュやガラガラいるしゴーストの種類は増えそう <\br>	neu
 ミミッキュがD105なことをたまに忘れてしまう <\br>	neu
 ミミッキュって化けの皮剥がれると中身見えると思ってたからクテンってなるだけで少しがっかり <\br>	neg
 今使っているポケモンも活かしてくれるとありがたいので念のため書きます  ミミッキュ　腕白　かげうち おにび まもる　つるぎのまい  テッカグヤ　いじっぱり　ヘビー　じしん　ストーン　ニトロ  フェローチャ　やんちゃ　とびひざげり　どくずき　冷凍　トンボ  ジュナイパー　すなお　かげぬい　リーフ　とんぼ　ブレイブ  ﾍﾟﾘｰﾊﾟｰ　ひかえめ　ぼうふう　ハイドロ　冷凍　とんぼ  ジャラランガ　ゆうかん　はらだいこ　スカイ　げきりん　じしん <\br>	pos
 ミミッキュの種族値割とクソやな  人気あるだけにもうちょい性能よくして欲しかった <\br>	neg
 呪い身がわりミミッキュはメジャーだろ  普通に剣舞型の次に警戒するわ <\br>	pos
 ストーリーはルガルガン、アブリボン、キュワワー、エンニュート、ミミッキュ、トゲデマル辺りをさくさく進む為に採用したいかな <\br>	neg
 ミミッキュ人気凄いね <\br>	pos
 攻: ミミッキュ Lv.50  防: パルシェン Lv.50  ダメージ: 118～141  割合: 83%～99.2%  回数: 確定2発  急所ダメージ: 178～211  割合: 125.3%～148.5%  補正: (ダメージ補正なし)  技: じゃれつく  威力: 90  タイプ: フェアリー*/物理  攻撃: 468+ [ラ]  防御: 200  最大HP: 142  天候: (ふつう)  相性: ×1 <\br>	neu
 ラティオスって剣舞ミミッキュのかげうちで乱数なのかよ  あほくさ、クビだわ <\br>	neg
 ミミッキュは、発売前の解析情報の時点でぶっ壊れだと見抜いてた奴だけ叩け  俺はくっそ叩いてたけど、どいつもこいつもカプだなんだで騒いでて、ミミッキュイカレつえーっつってた奴相当少なかったぞ <\br>	neg
 ミミッキュとテテフ両方見れる鋼マジでいねぇええええ  マジでバランス調整適当だな <\br>	neu
 グライも先手で毒打てばみがまもでハメ殺せる  ミミッキュに一方的にボコられるのはガブだけ <\br>	neu
 ミミッキュってよく考えたらタイプも優秀だわ <\br>	pos
 ツリーは襷ミミッキュで3タテしたのにいい勝負したみたいな台詞出てくるのほんと笑うからやめて  シロナてめーのことだよ <\br>	neg
 ミミッキュは準伝説が大量に来てからはやや厳しくなりそう  基本的に相性だけで戦ってるタイプだから種族値の暴力に弱い  現状でもメガマンダには分が悪いし <\br>	neg
 初手ミミッキュミラーてどうすればええの？ <\br>	neu
 掲示板出スピボ入り色ミミッキュ出したら♀色ホゲータでしかも6Vでレベル11だったけど本物なのかわかんねぇ  親の名前で検索してもヒットしてくれない 	neu
 ミミッキュのフェアリーZって通りよくないな  ゴーストZの方がうちたい場面圧倒的に多い <\br>	neg
 ミミッキュは俺が使うとじゃれが当たらん <\br>	neg
 Z浄化ナマコを吠えるで流したのに裏のミミッキュがまだスイクンの前で積んできてわろた <\br>	neu
 ミミッキュの中身の姿って解析で判明してないの？ <\br>	neu
 じゃあ新ポケはミミッキュだけパーティに入れればいいんじゃないかな <\br>	neu
 アニメのロケット団のパーティー結構強いな  ヒドイデ(進化すればドヒドイデ)  ミミッキュ(シャドクロ、じゃれつく覚えてる)  キテルグマ <\br>	pos
 デザイン的に使いたい奴とＵＢ抜きをコンセプトにして  ガオガエン・ミミッキュ・シルヴァディ（無）・メガメタグロス・キテルグマ・トゲデマル  で取り敢えず潜ってるけどやっぱり物理オンリーきついな…   ミミッキュ・シルヴァディ・メタグロスで流れを掴めばとことん行けるけど  ガオガエンの選出率なんてゼロという <\br>	neu
 6世代はパーティにガルが入ってないと欠陥  7世代はパーティに強いフェアリーが入ってないと欠陥  同じように見えるけどカプなりミミッキュなりフェアリーの多様性がある分ガルモンよりはマシな環境アフィ  もしこれがテテフなりミミッキュなり入ってないと欠陥って環境になったらガルモンの再来  若干そうなりつつあるけどな <\br>	neu
 ムンボ4Vミミッキュくんとはやりますねぇ！  ありがとナス！ <\br>	pos
 100Lv６V色違いミミッキュとかいう露骨な改造を流すのは何を考えてるんだ <\br>	neg
 襷ミミッキュでもええ <\br>	pos
 【配布】  ・C抜け4V夢フカマル（逆鱗アイヘ捨て身暴れる）＠ダイブ  ・C抜け4Vストライク（さざめきバトン銀風）＠ダイブ  ・A抜け4Vゴース（金縛怨念滅び）＠ダイブ  ・C抜け4Vミミッキュ（道連れ怨念呪い悪夢）＠ダイブ  ・C抜け4Vシェルダー（氷柱礫シェルブレロクブラ）＠ダイブ  ※アイテムのオマケ付き   1778-9827-2633　し○○○  ２時間くらいゆるりとやってますのでどうぞ！ <\br>	neu
 俺がさっき言った眼鏡テテフとトリルミミッキュって事でいいよな <\br>	neu
 ミミッキュはマスコット枠なのに破格の強さだわな  やっぱりダメージ一回無効は神だわ <\br>	pos
 ミミッキュはギャラドスより2速いのが納得イカンぜよ  明らかにギャラドスのが早そうなのに <\br>	pos
 メタグロスは命中不安定技がメインウェポンだからバトルツリーでは流行りにくいんじゃね?  ……その割にミミッキュが「～連勝！」みたいなブログによく入れられるけど <\br>	neg
 わんぱくゴツメランドロスにはたき落とす覚えさせたらミミッキュ対策出来るかな <\br>	neu
 ミミッキュにまとわりつく挑発道連れトリルされた  どんだけ突破力捨ててんだよ <\br>	neg
 ミミッキュしか作ってねーぞアローラ一般ポケ <\br>	neu
 ウ○コ、チ○コ統一パ組みましたレート1300目指します   ミミッキュ  ズルズキン  ハガネール  スカタンク  バイバニラ  テラキオン <\br>	neu
 ミミッキュにZはねるってどうなの？ <\br>	neu
 ミミッキュにすてゼリフかとんぼ返りください  でんじはくらいなら差しだせます <\br>	neu
 最速ミミッキュでテテフぶった斬りたいのとトリルみちづれ呪いしたいのでふよふよしてる <\br>	neu
 ミミロップは絶対再評価される。  ミミッキュの影打ち無効、糞多いポリ2に強い、猫石火でフェローチェ確定1、猫恩返しでコケコ確定1 <\br>	pos
 鬼火痛み分けの耐久ミミッキュ考えたけどこういうの昔ミカルゲでやってたわ <\br>	neu
 ミミッキュ剣舞やっぱいる？  かげじゃれ鬼火とりるだわ  みちづれも使いやすい <\br>	neu
 ミミッキュは適度にウザ強くて良調整 <\br>	pos
 キテルグマは進化無しか、進化前がいる  ミミッキュは進化しないけど着ぐるみがピカチュウじゃないやつが登場しそう <\br>	neu
 まぁミミッキュは素早さ10下げても良かったな <\br>	neg
 友達になろうミミッキュだYO <\br>	pos
 スイクンもzミミッキュにタイマンで負ける気がするけど  全ての持ち物想定でタイマンに勝てる奴ほとんど居ない気がする <\br>	neu
 襷ミミッキュとか上取られたら4回行動確定か？辛いわ <\br>	neu
 ミミッキュにゴロンダとか寝ぼけすぎてたわ  ジバコミミッキュポリ2なら鬼火瞑想シャンデラとかだろうか <\br>	neu
 新ポケはミミッキュとガラガラ2強かな  クワガノン技範囲のひろさもいいが <\br>	neu
 かたやぶりドリュウズが解禁されたら  アイアンヘッドでミミッキュワンパンいけるかな？ <\br>	neu
 シナリオの難易度高かったのか  いやまあエンニュートとミミッキュ採用して積みボッコしたからぬるく感じたんだろうが <\br>	pos
 フリー潜ってたら「ミミッキュが強い」ってことだけをどっかで聞いたであろう初心者と当たったわ   シザークロスとかシャドーボール打ってきた  クレセリアが突破出来ずに死んでた <\br>	neg
 ミミッキュの積み技からのかげうちかじゃれつくまじで強いんだが  対策ある？ <\br>	neg
 UBはお手軽ツリー稼ぎキャラなのになぁ  フェローチェ、テッカグヤ、コケコ、テテフ、ミミッキュの五大ポケ出せば余裕やぞ  努力値無振りでもBP稼ぐくらいなら余裕やし  S振ったガブもいたら超楽やがな <\br>	neu
 メガヤドラン  ラッキー  ピクシー  キュウコン  ポリゴン２  ミミッキュというゴミみたいなパーティーと出会った <\br>	neu
 ミミッキュとイワンコ予約したー嬉しい  転売カスはシネ <\br>	neg
 砂とはたきとステロとで襷ミミッキュとかいうとりあえず1.2体持っていくマンが少し減りそうでなにより <\br>	neu
 アナライズポリ2って都市伝説レベルしかいないのか？  ミミッキュ多いしトレスやダウソみたいに状況を選ばないから便利なんだけど <\br>	neu
 ミミッキュはタイプが優秀すぎる上に絶妙な種族値  種族値は決して高くはないがぶっ壊れの特性で補ってる上に補助技もクソ多い  余裕で生き残れるよこいつ  まるでガブリアスみてーな存在だぞ   アローら版ガブリアスといってもいいレベル <\br>	pos
 夢クズモー1boxと他ミミッキュヒトカゲテッシード等孵化あまり2boxで参戦する <\br>	neu
 ウツロイドフローチェミミッキュ  この3体で1時間やればとりあえず赤い糸分くらいは集まる  ムーン限定だが <\br>	neu
 テテフナイトとミミッキュナイトまだ？ <\br>	neu
 ｚ技といえばｚはねるミミッキュってダメなのかな？ <\br>	neu
 初めてフリーで特殊ミミッキュみたわ  上手く四杯弱点付かれたな負けたよ <\br>	pos
 ランドマンムーカバはミミッキュに強いけどガブは竜が邪魔して勝てない <\br>	neg
 ミミッキュは雑魚すぎる  種族値足りてないよ <\br>	neg
 Z技ってメガシンカと違ってどのポケモンでも切り札みたいに使えるのが魅力だったはずなのに  現実はミミッキュだのガブリアスだのバシャーモだのギルガルドだの  素で一線級のやつらにインフレ材料与えただけだったってのがね <\br>	neu
 ミミッキュは接触技しか無いしガルドとは完全にじゃんけんだろ  どっちが有利とか無い <\br>	neu
 3→4世代並みの環境の変化が欲しいわ  新ポケで生き残ってるのミミッキュとカプくらいで前世代から調整なしでそのまま流用しても使えるし  いっそ技も特性もばら撒いてくれ <\br>	neu
 ドリュウズとかいうコケコテテフミミッキュをまとめて黙らせる仕事人 <\br>	pos
 [名前] カリスマ  [国と県] 日本  [フリー・レート] レート  [パーティ] テテフ、ミミッキュ、ラッキー  [切断状況] 小さくなるラッキー使ってるにも拘わらず負け確で切断のゴミ <\br>	neg
 ミミッキュみたいな種族値でも戦えるように調整されてるのはすごい  ポケモンは神ゲー <\br>	pos
 結局新ポケでレートに顔出しそうなのミミッキュとカプとUBか <\br>	neu
 今はルカリオで全抜きするよりは削り+ルカリオ+襷ミミッキュみたいな編成がいいと思う  動きやすくなったが通りは前環境よりは悪い <\br>	pos
 いないと困るか？  ミミッキュのシャドボとかで落ちるんじゃないの <\br>	neu
 ツリーはUBあかんな、ミミッキュが人気らしい <\br>	pos
 ミミッキュのせいでミミッキュ以下の素早さの奴は入れにくいしとんボル必須になった気がする  そりゃシャドボ持ちポリゴン2誰でも使うに決まってるわ <\br>	neu
 冷静に考えたらミミッキュはジャラランガのメイン2タイプ無効だYO  凄いYO  速さでも勝ってるYO <\br>	pos
 テテフフェローチェってどう？テテフで削ってフェローチェで全抜きするガルドミミッキュは知らん <\br>	neu
 ミミッキュに鬼火はありでしょうか？  その場合抜くとしたら影うちとシャドクロどっちがよろしいですか？ <\br>	neu
 某PT相性検索ツールの人気ランキングでミミッキュがガブの1個下まで登りつめててワロタ <\br>	pos
 ミミッキュドドゲザンカイリューみたいなの使ってるからラウドボーン絶対出てくるわ 	neu
 ミミッキュは中身の首の骨をバッキバキにしたい  見るだけでイラつく <\br>	neg
 HDにして受けに来た奴起点に強引に舞っても結局ミミッキュ後投げされたら引かざるを得ないのがなあ  皮ウザ過ぎるわ <\br>	neg
 ラブボに入ってるくせに無限闇夜うってくるミミッキュ <\br>	neu
 ゲンガーにするくらいならミミッキュでいいだろ  メンタルハーブで確実に１回できるぞ <\br>	pos
 しれっと入ってるけどカイリキーはあまりないだろw  ゲンガーと同列でミミッキュだと思うわ 	neu
 WCSルールレート使用率上位30体でカプ・UB・ミミッキュ除いたらサンムーン初登場はトゲデマル位しか残らないような・・・ <\br>	neu
 ちなみにパーティは  ゲッコウガ　ガブ　コケコ　リザX ヘラ　ミミッキュ  やっぱ構築が悪いのか <\br>	neg
 シングルだとマンダよりギャラのほうが人気あるんだな  ギャラ人気はミミッキュのせいだけど、コケコにぶっささるのがきつい <\br>	pos
 ミミッキュのピカチュウの顔部分はミミッキュ一匹一匹が一生懸命書いてるのか？ <\br>	neu
 ミミッキュの隣に描かれてたのと見た目の不気味さのせいで、キテルグマは最初ゴースト格闘かと思ったわ  どう見てもアブノーマル臭いのにどこがノーマルだよ <\br>	neg
 ミミッキュってパルシェンじゃだめなのか？ <\br>	neu
 カエンジシがいればミミッキュなんぞ・・ <\br>	neu
 グロスはランキング上位のポケモンに強い上に対面でもなきゃ別にミミッキュに不利でもないし   仮にミミッキュと対面しても一撃じゃ殺されないし怯み殺せることも多い  あと死に際でもバレパンで皮剥がしできる <\br>	neu
 ミミッキュをメガギャラで見ようってのはダメな気がする  安定しないでしょ？ <\br>	neg
 今のところ環境にからんできそうなのはカプ・コケコくらいか  シロデスナ、バンバドロ、キテルグマあたりも高種族値っぽい見た目だけど  ミミッキュ、ハギギシリも個性がって使ってみたいがもう1段階進化してほしい <\br>	neu
 ミミッキュの種族値優遇されすぎってマジ？  A90だぞよく見ろよ <\br>	neg
 ミミッキュはカイリューと一緒だから <\br>	neu
 ミミッキュ <\br>	neu
 可愛さ人気をミミッキュに取られたかわいい電気枠がいるらしい <\br>	pos
 ミミッキュなんで鋼ゴツメで勝ってに死ぬし（呪い型は無理）  それより今俺の中でダダリンの株がめちゃくちゃ上がってる  最初は草いらねーとか思ってたが催眠厨には丁度いいわい <\br>	neg
 ミミッキュは素で強いな  剣舞にアムハンまであるしシナリオでも活躍しそう <\br>	pos
 ヌシの中でもヨワシはひときわ強い強い聞くな  ヌシミミッキュもかなり強いらしいがどうなんだろ <\br>	pos
 ダブルでミミッキュテテフが流行ったりする？ <\br>	neu
 ガブはミミッキュテテフの後ろにいる奴に強いしまあ <\br>	neu
 初めてミミッキュ公開されてばかのかわの説明読んた時  一回攻撃無効化した後みがわり状態になるのかと思ったわ <\br>	neu
 ミミッキュは皮かむりの真性包茎って考えたら、テテフやアマージョあたりの攻撃受けて皮剥けるたびに興奮する。 <\br>	pos
 困った時は襷ミミッキュかガブでいいんじゃないですかね… <\br>	pos
 ミミッキュってムーン時間の夜にしかでないとか？  ムーンでいま跡地うろうろしてるけどでない… <\br>	neu
 考えた物理受け候補としては  ヤドラン→ミミッキュが無理  ドヒドイデ→マンダが無理  マッシブーン→物理ルカリオ以外無理  ポリ2→ルカリオが無理  エアームド→ルカリオが無理  サンダー→ミミッキュと特殊マンダが無理  ナマコ→マンダもルカリオも後出しだと無理   パーティ全体で厚くしないとだめだな <\br>	neg
 本当は地割れヘイラッシャじゃなくて呪いミミッキュ使いたいんやけどな、まだカムラの実が無いねん 	pos
 ミミッキュ3回目でいきなりMLUドロップしたが  確率が0.56なのかどうかはもっと回さないと分からないな・・・ <\br>	neu
 ミミッキュにすてゼリフかせめてとんぼ返りください  でんじはくらいなら差し出します <\br>	neu
 ジャロは対面からコケコミミッキュガブの選出完封出来るから新緑でも全然行けた ハッサムは死ね <\br>	pos
 ガルドとミミッキュがいるから中低速の高耐久もなんだかんだいるけどな  だからフェローチェに地震ください <\br>	neu
 テテフの処理ルートはミミッキュしか安定しない  他は信用できないし <\br>	neg
 はたきやらバンギが増えると襷潰されるもんでストッパーミミッキュは若干逆風かね  メガバナは強いが基本マンダには弱いんでどうなるか <\br>	neg
 攻撃特化ミミッキュはある程度減りそうだがサポート型は減らんと思うわ  何が何でも仕事をするという社畜の魂を感じる <\br>	neg
 ゴツメクレセも突破できるガルモンは文句なく壊れでいい  ミミッキュ程度だったら壊れでも何でもない <\br>	neg
 水統一のゲッコウガは賛否分かれるところだけどバナとミミッキュに関しては完全に言いがかりで草 <\br>	neg
 バレから発売まで旅パ妄想するのが最高に楽しい  新出・見た目重視・複合タイプかつ被らせないルール優先、で今の所  モクロー、アブリー、ヤトウモリ、ジャラと  オニヒトデ、錨、ナマコ、ミミッキュ、ニャース(ものひろい用未進化)から２匹だな  オニヒトデが水と鋼地岩あたりだと嬉しい <\br>	pos
 低レートなのに異常に読みうまいやつなんなの？  なんでこんなうまいのに低レートなのか謎すぎる  ポリ2の電磁波みてるのに2回もバシャがミミッキュ読みフレドラとかなんで低レートのくせにできるんだよ  バシャに麻痺入ったら負けやんお前  これだから低レートとやるのは嫌なんだよなあ <\br>	neg
 てきとーにガブ（すながくれでもいい）育てて  襷もたせて、つるぎ→逆鱗  もらした奴にミミッキュ、Z技ゲンガーで普通のシングルは行けるだろｗ   48BPなんてすぐよ <\br>	pos
 テテフとミミッキュがやっぱり強い  削り性能、場を荒らす性能の高いミミッキュと速くで超火力で先制無効のテテフはやっぱりおかしい <\br>	neg
 厳選考えたらサンの方が若干楽かね？  でもミミッキュを旅で使いたいし迷う   フラゲしてるやつはオススメ教えてくれ <\br>	neu
 サンムーンで初国際色ミミッキュきたー  A死んでたから王冠ありがたや <\br>	pos
 Zはねるミミッキュに出会った  挑発対策だとすればありか？まぁ吠えるしちゃった訳だが <\br>	neu
 襷ミミッキュ <\br>	neu
 鬼火ミミッキュうっぜぇ <\br>	neg
 メガハガネールはミミッキュ対策には持ってこいでしょ  ロクブラ→ヘビボンで落ちるだろうし  鬼火は眠れ <\br>	pos
 ミミッキュ使いたいキテルグマ使いたい  キテルグマはHAでよさそう <\br>	neu
 残すはスーパーマルチのスタンプだけだから挑戦しようとおもうんだが  ＣＰＵの相方書くのでこちらのおすすめの２匹教えてくれ  先発意地ASゴツメミミッキュじゃれつくシャドクロかげうちみちづれ  控えめHCメガサーナイトサイキネはかいこうせんシャドボきあいだま <\br>	neu
 呪い身がわりミミッキュとかいうの使ってみたけど強過ぎて笑う <\br>	pos
 ミミッキュもテテフもせいぜい重力くらいだろ <\br>	neu
 クワガタの色違い最高にカッコいい  ミミッキュの色違いは初代っぽくていいな <\br>	pos
 ミミッキュは蝶の舞あげるから剣舞と影うちやめて <\br>	neu
 粉持ちまとめといた   炎ロトム　おにび/たたりめ/あやしいひかり/チャージビーム  モロバレル　かげぶんしん/ギガドレイン/どくどく/いばる  ブルンゲル　とける/じこさいせい/あやしいかぜ/ねっとう  ブロスター　いやしのはどう/だくりゅう/かげぶんしん/ないしょばなし  エンニュート　かなしばり/まもる/アンコール/ヘドロばくだん  ラプラス　なみのり/れいとうビーム/１０まんボルト/サイコキネシス  ジバコイル　チャージビーム/ラスターカノン/でんじふゆう/でんじは  エムリット　みらいよち/いやしのねがい/まねっこ/でんじは  ジュナイパー　わるだくみ/シャドーボール/くさむすび/バトンタッチ  ドリュウズ　すなあらし/じしん/いわなだれ/どくづき  ゴチルゼル　みがわり/おだてる/じこあんじ/サイコキネシス  ムウマージ　パワージェム/まもる/ほろびのうた/くろいまなざし  グレイシア　ふぶき/シャドーボール/オーロラベール/みきり  エレキブル　でんじは/きあいパンチ/いわなだれ/ほのおのパンチ  ダグトリオ　じわれ/どくどく/みがわり/すなあらし  ジャローダ　リーフストーム/みがわり/はかいこうせん/どくどく  サーナイト　アシストパワー/１０まんボルト/めいそう/かげぶんしん  ミミッキュ　シャドークロー/きりさく/かげぶんしん/でんじは  ランドロス　ねむる/ねごと/うちおとす/じわれ  サンダー　チャージビーム/げんしのちから/かげぶんしん/はねやすめ  氷ロトム　かげぶんしん/チャージビーム/じゅうでん/あやしいかぜ  ガメノデス　ストーンエッジ/シェルブレード/からをやぶる/かげぶんしん  オニシズクモ　かげぶんしん/どくどく/たくわえる/アクアリング  ケンホロウ　みきり/フェザーダンス/どくどく/そらをとぶ <\br>	neu
 正直アローラのポケモンで生き残りそうなのってテテフブルルカグヤくらいしかいないよな  ガラガラは当然消えるしミミッキュも数値足りなすぎてキツイ <\br>	neg
 ミミッキュを抱き上げて上に上がった衝撃で投げ飛ばすあそび <\br>	pos
 新ポケで一番可能性あるのダブルのミミッキュなんじゃないかと思う <\br>	neu
 メガグロスもメガでエスパーなくせよ  ミミッキュにクソ強くなるしさ <\br>	pos
 [名前] ネス★  [国と県]  [フリー・レート] レート　1745  [挨拶]  [パーティ]マンムー（気合いの襷、ステルスロック、がんせきふうじ）　ウルガモス（ノーマルZ、ちょうのまい、はかいこうせん）　ボーマンダ（りゅうのまい） ミミッキュ　エーフィ　パルシェン  [切断状況] 名前の後ろに★マークを入れて女を気取るネカマ。余りにもキモかったので晒します。雑魚かったし圧勝したけどなw <\br>	pos
 ミミッキュに霊フェアリーか  俺のムウマージたんもフェアリーもらえるかな…  頼むぞゲーフリ、あの子マジカルポケモンなんだぞ <\br>	neu
 ミミッキュ使いは脳味噌腐ってるからしょうがない  適当に舞うかZ技でゴリ押すだけで勝てちゃうんだからそら脳も退化するわ <\br>	neg
 テテフバシャ流行るだろうからトリル使いたいんだけど、始動はミミッキュとしてアタッカーは誰がいいだろう <\br>	neu
 ミミッキュってなんかいい解答ないの？  メガギャラあんま好きじゃないんだけど <\br>	neg
 ミミッキュは新しい世代の風感じて好きよ  環境は世代ごとにどんどん変えるべき  どっかのブサイク鮫はいい加減s下げろ <\br>	neg
 ミミッキュのせいでうちのマイナーポケモン達が息してないわ <\br>	neg
 ガルドゲンガーくらいの強みがない限りミミッキュ以外のゴースト使う理由ないよね <\br>	pos
 ミミッキュは他の被り物パターン用意されてるといいなぁ <\br>	pos
 ミミッキュの登場により  ゲームの中の世界でもピカチュウは  ポケモン界No. 1なんだな <\br>	neu
 ミミッキュが600族になったらどうなるのっと <\br>	neu
 環境煮詰まったら次第に淘汰されるかもね＠ミミッキュ  いまはごった煮状態でカオスだから存分に?きまわせる <\br>	neu
 オニシズクモ、ガラガラ、キュウコン、ヤレユータン、ミミッキュ  この辺りはバンク解禁後もそれなりに見そう <\br>	neu
 コオリッポ自体は悪くないのにミミッキュが悪さしたせいでドリュウズが蔓延して特性使いにくくなるし、S130は間違いなく早いのにドラパルトに抜かれるし、ダイアイス無いのはしょうがないけどSVでイカサマダイス追加されたのにつららばり没収されるし散々だわ 	neg
 ナマコの前で剣舞ガン積みしてくるミミッキュバレパンマンかなり多いけどなんなん？  カウンター警戒にしても現環境のナマコなんて9割天然で中身なんてほぼ見ないし意味なくね？ <\br>	neg
 ミミッキュ10万ボルト覚えるのか  ミヅキちゃんのフェアリータイプのZダンス可愛い <\br>	pos
 シロデはBとSが低そうなのがなぁ  ミミッキュは習得技次第だな <\br>	neg
 WCSにジュナイパーガオガエンアシレーヌトゲデマルミミッキュで潜ったけど割と勝ててワロタ <\br>	neg
 UBについては発売前に全部公表したのも不満だな…  ネクロズマくらいは隠しても良かったと思う  解析ネタバレをわざわざ避けてたのに結局公式が御三家最終進化もUBもバラすのはつまらない  あとついでにいえばヨワシやミミッキュを知らないまま試練してみたかった  UBを全部バラしたのは結局バレても問題ないどうでもいい存在だったからだろうな  公式は隠してたけど戦いもしないルザミーネビーストだってどうでもよかったがな <\br>	neu
 メガミミはないと困る　ミミッキュとかいうカスぶっ殺したいし <\br>	neg
 がむしゃらタスキミミッキュとかは流石に微妙か <\br>	neg
 ポリゴン対策にメガヤドラン、ミミッキュ対策に天然ピクシー作ったわ  割とミミッキュ対面だと舞うから楽だわ <\br>	pos
 ミミッキュののろいはオニゴーリに強いな、切断してくれたよ <\br>	pos
 ミミッキュはエンテイのお祈り聖なる炎で焼く  焼けなかったら諦める <\br>	neu
 そういや昨日一人でシコシコ更新してみたから貼ってみる   タイプ別の新ポケ数  （）内は旧ポケのリージョンフォーム   妖7　マギアナ、カプ・コケコ、アブリー、ミミッキュ、キュワワー、（ロコン）、（キュウコン）  飛7　モクロー、ツツケラ、メテノ、めらめらオドリドリ、ぱちぱちオドリドリ、ふらふらオドリドリ、まいまいオドリドリ  無6　ヤングース、デカグース、ツツケラ、ネッコアラ、ジジーロン、キテルグマ  鋼5　マギアナ、トゲデマル、ソルガレオ、（サンド）、（サンドパン）  電5　デンヂムシ、クワガノン、カプ・コケコ、トゲデマル、ぱちぱちオドリドリ  草5　モクロー、アマカジ、カリキリ、ラランテス、（ナッシー）  超5　ソルガレオ、ルナアーラ、ハギギシリ、ふらふらオドリドリ  虫5　アゴジムシ、デンヂムシ、クワガノン、アブリー、コソクムシ  氷4 （ロコン）、（キュウコン）、（サンド）、（サンドパン）  水3　アシマリ、ハギギシリ、コソクムシ  炎3　ニャビー、ヤトウモリ、めらめらオドリドリ  霊3　ルナアーラ、ミミッキュ、まいまいオドリドリ  岩2　イワンコ 、メテノ  竜2　ジジーロン、（ナッシー）　  地2 ドロバンコ、バンバドロ  毒1 ヤトウモリ  闘1 キテルグマ  悪0 <\br>	neu
 トンボルチェンが対ミミッキュで猛威を振るってる現状、風船なんてあってないようなもんだと思う  シュカでどこまで耐えられるか計算したわけじゃないが仕事できるならシュカでいいんじゃない <\br>	neu
 でもレートでフェローチェ全く見なくなったな  ガブマンダギャラテテフサザングロスガルドコケコガラガラカグヤがトップ10だと思う  次点でミミッキュウツロイド辺りか <\br>	neu
 ツリー用の珠ミミッキュHAかASで迷ってるんだがどっちのが方が効率いい？ <\br>	neu
 襷めざ氷でガルド使ってるけど、今キンシガルドが多いせいかクッソ刺さるぞ。  ミミッキュとガブとマンダがキンシ読みで舞って死んでいくのが何回もあった <\br>	neu
 ノーマル　：ラッタ/デカグース  かくとう　：マケンカニ  どく　　　：（ヤトウモリ？）  じめん　　：バンバドロ？  ひこう　　：ペリッパー？  むし　　　：（コソクムシ？）  いわ　　　：ルガルガン  ゴースト　：ミミッキュ？  はがね　　：（ゴローニャ？）  ほのお　　：ガラガラ？  みず　　　：ヨワシ  でんき　　：（クワガノン？）  くさ　　　：ラランテス  こおり　　：（サンドパン？/キュウコン？）  エスパー　：（ヤレユータン？）  ドラゴン　：ジャラランガ？  あく　　　：（ベトベトン？）  フェアリー：（アブリボン？） <\br>	neu
 ミミッキュ対策でまたトゲカッスの時代が来てしまうのか <\br>	neg
 でもzあってもポリ2が普通に数値受けしてたやん  ガルクレセドランは鬼火ミミッキュがクソ重そうだけど <\br>	neu
 キテルグマはピンク色と頭飾りでポケモンセンターの  ジョーイの助手枠かと思ったりしたが危険すぎるな   ミミッキュは電気技とか覚えるのだろうか  対戦で電気タイプと勘違いするやつは居なそう <\br>	neu
 ミミッキュようやく取った  被り物の目とか口はシールなんだね  手入れのときは剥がれないように注意が必要かな <\br>	pos
 あーうぜえ  ミミッキュ56す <\br>	neg
 ミミッキュ相手にいるとめんどくさいけど自分のは6匹の中で一番選出率低いわ  火力がなさすぎる <\br>	neg
 ミミッキュがバージョン限定かどうか  そうならどっちに出るか情報ほしいわ <\br>	neu
 ミミッキュとかいう弱体化確実のポケモン <\br>	neg
 ミミッキュつっよ  いるだけで変な読みしてくる  もはや選出してないのに強い <\br>	pos
 ミミッキュくんのイベントは最後の最後で黄色い物体が建物の陰から覗く演出が怖すぎるっピ！ <\br>	neg
 ウツロガブミミッキュでツリー進めてたらAKRM兄貴のメガメタグロスに三縦されました…(絶望)  先発が不利な時は捨てる覚悟も要るってはっきりわかんだね <\br>	neu
 そのアセロラと話してる時後ろにミミッキュいるよね <\br>	neu
 ミミッキュの中身がライチュウの怨念じゃね？ <\br>	neu
 スカーフミミッキュとかいう変態だったとしか <\br>	neu
 ミミッキュにおんねんが遺伝できない  あくむ、のろい、みちずれ、まねっこの♀とおんねん覚えたムウマ♂  まねっこってもしかしてタマゴ技でもある？ <\br>	neu
 確かに国際孵化でミミッキュ粘ってた間はよく通常が色に見えてた  もう余裕無い時は色は見ずに後で逃がす時に赤い星あるかないかだけ見てたよ <\br>	neu
 6世代ガルーラ「ミミッキュへの抑止力に私が必要なようだな……」 <\br>	neu
 とりあえずミミッキュとアローラライチュウ <\br>	pos
 シーズン3はクチクレセポリ2ミミッキュが増えそうだから、うちの毒毒搭載ゴツメランドが刺さる予感。 <\br>	neu
 ミミッキュよりも前作から暴れ続けてるガルドとかいうゴミをなんとかしろよ <\br>	neg
 ミミッキュに連続技打ったらどうなりますか？終わってか化けが剥がれる感じ？ <\br>	neu
 ポケリフレで初めてミミッキュにポケ豆あげる時、絶対引っ掛かるよね。 <\br>	neu
 陽気最速弱保ロッカドサイドンでコケコ抜きや  と思って作ったけど、まあスカーフ連中に蹂躙されるのが辛い  ASだと保険発動してから特殊技一発も受けられないし  パルシェンと違ってミミッキュに確実に勝てないのも辛い <\br>	neg
 もうミミッキュ弱体化はよ  相棒のグロス君が死んでいったやないか  ばけのかわとかこんなんチートやろ <\br>	neg
 ミミッキュのせいでミミックが発音できねえ  キュになるわ気持ち悪い <\br>	neg
 メガシンカ禁止で天敵がいないからミミッキュ君で剣の舞してればアローラフレンドリー1700は余裕で行けて笑っちゃうぜ！ <\br>	pos
 襷ミミッキュでトリルしてテテフで殺す <\br>	neg
 ライバロリパーティに当たったんだが  ルカリオをギャラの起点にして三たてしたったわw  ミミッキュとか卑怯ポケモン使いやがってよー <\br>	neu
 ミミッキュなんてメガハガネールで余裕だぜ <\br>	pos
 一つ聞きたいんだがミミッキュとフシギバナが対面したらどっちが勝つ？  バナ側に有効打無いし6回積まれて終わりよな <\br>	neu
 あのミミッキュいつも複数相手を強いられててかわいそう <\br>	neg
 コケコとミミッキュを葬り去る型破りドリュウズ早く来てくれ～ <\br>	neu
 4時間もレートやったの久しぶりでめっちゃ疲れた  スイッチトリルの使い方はわりと慣れてきたな  あとガッサ入れてるとほぼ初手コケコ来るから読みやすかったな  他にゲッコウガミミッキュもいて刺さってたからだろうけど  コケコ入りには毎回テテフ先発に置いてた  ただ壁貼りとか鈍足鋼と高速高火力アタッカーが並んでると崩すのが難しい <\br>	neu
 なんとか買えたけど果たして本当に欲しい人には行き渡ったのだろうか…  昨日のAmazonのフライングがなければまだマシだったかも  ロコン、ミミッキュ、モクロー関連は早めにいかないときついな <\br>	neu
 <｀∀´>ｸｸｸ…そうニダ 厳選はかなり甘くしてるし  ミミッキュなんてGTSで手に入れたのに努力値振っただけニダ  しかし、メガルカリオって強かったんだな <\br>	pos
 ミミッキュは影打ちもあるしとりあえず剣舞してじゃれついときゃ強そう  Sが96と意外に速いししんそくマッパ無効だし <\br>	neu
 ゲームフリーク戦犯-其の3   ■岩尾和昌(いわお かずまさ) 【SMコンセプトプランニング、USUMディレクター等担当】  ・SMでは、バトルシステム関連や新要素(Z技とそのポーズ、試練、UBなど)に携わる  ・USUMではディレクターを担当、大森の悪い部分を正確に引き継いだ後継者候補と化す  →その上自身専用のゲーム内顔グラを作らせ、USUM内トレーナーとして登場  ・剣盾でメガシンカとZ技を廃止した上でダイマックス関連の新システムを考案  →ダイマックスで全てのポケモンが強化され平等なシステムかと思われたが、メガシンカと同じく一部ポケモンのみが持つキョダイマックスが出てきた   ■杉中克考(すぎなか かつのり) 【USUMストーリープランニングセクションディレクター等担当】  ・「アローラ」というふざけた挨拶とポーズを発案し、これを松宮と話し合い決定  ・SMキャラとの性格や行動等の矛盾、ヌシール、エピソードRR団を考案  →海外(カントー地方外)出身のマチスのクチバジムの仕掛けをカントーの人間が作った文化としてジムオブカントーに登場させてしまっている  ・サブイベント100個以上追加などという虚言   ■森本茂樹(もりもと しげき) 【SM・USUMバトルプランニング、USUMシステムプランニングディレクター等担当】  ・ORASまでバトルディレクターを担当し、6世代では壊れ性能を持ったメガガルーラや疾風の翼を考案  →これらは7世代で弱体化されたが、7世代では新たにミミッキュやカプ・テテフ等を投入  ・特殊ギルガルドが予想外だった旨やバトル解説など、エアプとしか思えない発言が目立つ  ・操作、効率、厳選など様々な面で問題点を抱え、過去最低レベルの収集要素であるウルトラワープライドを監修  ・自分たちが生み出したポケモン(カプ・テテフ)に対し「いなくなればいいのに」と漏らす 	neg
 ポリクチミミッキュ対策にドランつかうかな <\br>	neu
 http://i.imgur.com/elhxEUM.jpg  鉢巻ギギギアルならギアソーサーの1回でミミッキュ沈むのか  ギギギアル始まったな <\br>	neu
 トリルゲンガー生まれたしトリルミミッキュも有りなのかもしれない  出来ること違うけど <\br>	pos
 カプ×4  ミミッキュ  アロベトン <\br>	neu
 ミミッキュスキルマックスにするの確率的に20万弱って所なのかな  投資分見返りがあるのだろうか <\br>	neu
 カバ嫌いすぎてラムパルシェン採用してたけど普通にあくび以外のうってくるから困る  でもラムあるとミミッキュを前に安心して積めるんだよね <\br>	neg
 ミミッキュつっよ <\br>	pos
 ドリュウズ流行ったら陽気ミミッキュで鬼火して後の起点よ <\br>	neu
 ミミッキュ見たらカグヤ投げてるからか全然苦労した覚えないな  火力低すぎて剣舞積んでも怖くないぞ <\br>	neg
 Z技ミミッキュで受けてたけど何があかんの？ <\br>	pos
 ラス1でミミッキュ出してくるやつって絶対性格悪いよな　  死ねよ <\br>	neg
 剣舞挑発シャドクロミミッキュこそ対受けルにて最強 <\br>	pos
 色ミミッキュと色ドラメシヤくれ   	neu
 ミミッキュいなかったらヤーティガチで組んでたのになぁ <\br>	neu
 ミミッキュはともかくパルはアローもガルも弱体化でテテフという相棒を手に入れたから減るとは思わんけどな  まあ単体でミミッキュメタのためだけに採用するのは減るかもしれんけど <\br>	neg
 襷ミミッキュ使ってる奴みんな4んでくれ… <\br>	neg
 コケコミミッキュ辛いなら辛いなりにジバコなりハッサムなり入れればどうとでもなると思うんだがなぁ  悪・竜はお友達作りやすいタイプなんだしさ <\br>	neu
 ミミッキュの技全部半減以下にできるポケモンがカロスに居るジシよ <\br>	neu
 パルは型が決まりすぎてて  ミミッキュガルドガブテテフは型ありすぎやろ <\br>	neu
 【急募】良いミミッキュ処理ルート <\br>	neg
 ミミッキュはこれ進化しそうにないがデンヂムシみたいなのもあり得るかな  輝石運用前提で <\br>	neu
 ラブボミミッキュやったぜ  何故かモクロー厳選しといて良かった <\br>	pos
 むしろレヒレは突破できてコケコが若干怪しい  ミミッキュは襷だと対面から負けるのでもうだめぽ <\br>	neu
 ミミッキュムーン限定ってガセアフィ？ <\br>	neu
 そういや地味にミミッキュなんかもつらいな  剥がせばガルドで処理できるが消耗が大きい <\br>	neg
 入荷遅れの店でなんとか保管分のミミッキュゲットしてきた  苦手なＤリングだったけどけっこう楽に取れた  あとは来月のでっかいシロンちゃんまで休むとしようか <\br>	pos
 襷ミミッキュなら死に出しからほとんどのパターンに対処できるね <\br>	neu
 初期の頃ミミッキュの剣舞をアンコで縛ったのにZ技飛んできたのが未だに忘れられない  ちょっとトラウマ <\br>	neg
 今回一番フェアリーが埋まったな  アブリー、キュウコン、ミミッキュと３タイプ <\br>	neu
 タスキミミッキュ殺しは誰にすればいいのよ？  スカーフドリュウズはギャラあたりに交代されて起点にされそうで良くない気がする <\br>	neu
 道連れタスキミミッキュに遭遇してワロタｗｗｗ <\br>	pos
 毒守ガルドと普通のアタッカーガルドで全てのタイプに対応出来るのがほんとひで  ミミッキュといいゴーストに壊れ特性与えんなや <\br>	neg
 テテフもコケコもミミッキュも別にぶっ壊れじゃないけどな  むしろ良い感じの調整出来てると思う今回は <\br>	pos
 ミミッキュ弱体化は皮状態では補助技が使えないでおｋ <\br>	neg
 ミミッキュとハッサム倒せるやつ教えてくれマジで <\br>	neg
 ステロ吠えるが一番いいかなぁ  バシャミミッキュだけならギャラでいいけど控えにレボルトがいるのが殆どだし <\br>	pos
 論者ってミミッキュの前に全滅寸前やないんか <\br>	neg
 とりあえず赤い糸手に入ったしミミッキュ何育てようかな  ミミッキュあたりがいいかな <\br>	pos
 ミミッキュは猫無効トリラーとしての面も持ってて  鬼火壁貼りできて意外に器用  ダブルでもいい子だしこの先長く環境にいそう <\br>	neu
 さんざん言われてたポリクチミミッキュどうよ？  まだ潜れてないから分からんけどいい感じ？ <\br>	neu
 ミミッキュさんの人気すごい…  もう品切れ起こしてる  http://i.imgur.com/RXie1ZY.png <\br>	pos
 呪いミミッキュ後出しから何とかできない？  相手のカイリューが場に出たの見えてからすぐに後出しする   鉢巻なら神速逆鱗は透かせて地震は少し嫌だが最低限呪える  竜舞型なら死に出し等からこちらの表のポケモン起点にしようとしてきて大体初手竜舞なので皮の1ターン保証使って呪う  渦型はこれも呪いぶち込めるし遂行遅いし相手視点アンコ安定択に見えがちなのでゴーストで拘束抜けが可能なミミッキュが残る展開も考えられる   最近並びとして採用されがちな裏のサーフゴーもミミの前には流石に出てこられない  ミミッキュは勿論死ぬあとは何とかしろ 	neg
 ミミッキュのヌシ戦強すぎてふいたわ  レアコイルじゃＳ遅すぎて２体がかりで来られると回復おいつかんｗ  でんじは挟んでるひまねえｗ <\br>	neu
 パルシェン増えたのは間違いなくミミッキュの影響だな  テンプレミミッキュだとただの起点だし <\br>	neu
 バロの動画見たけどミミッキュやっぱ火力足りねえな  アタッカーにするより補助に回した方が強いんじゃねえかな <\br>	neg
 ミミッキュ対策？そらTalonflameよ <\br>	neu
 ミミッキュは相手のPTが疲弊するまで裏で待機してるから  ドリュウズ少しでも削られたらキツいだろうな  ミミッキュを対策できるかは立ち回り次第だ <\br>	pos
 ミミッキュはアローラ一般ポケモンで最強だけでなく最恐の座も獲得した模様  https://pbs.twimg.com/media/C3GDIQ6VUAQK0_o.jpg <\br>	pos
 そこそこ適当なPTでいいからレートに速く潜りたい！  けどグロス・ジバコ・ミミッキュ・オニシズグモ・ウインディ  であと一匹これ育てようってのがしっくりこない！  誰か知恵を貸してくれ、UBとカプ以外でだ <\br>	neu
 ミミッキュにねこだましは深い <\br>	neu
 ミミッキュのぬいぐるみは出そうだな <\br>	pos
 スイクンでも火傷させないとミミッキュに突破されて壊滅コースはいる  ミミッキュほんとやばすぎ <\br>	neu
 のろいでバトン対策やゴーリ対策にもなるしねミミッキュ <\br>	pos
 ミミッキュの技スペが足りない <\br>	neg
 ミミッキュはかわいい <\br>	pos
 最近は襷ミミッキュ減って殆どがZ撃ってくるな  まあ簡単に4倍火力出せるんだからそら相性いいが <\br>	neu
 アローラ一般ポケマジでミミッキュ以外死んだなｗｗ <\br>	neu
 なんかラブボ入れたいのいねーかな  アマカジカリキリヤトウモリガーディイワンコミミッキュモンメンチュリネは拾ってきた <\br>	neu
 ゴーストってだけで強ポケだもんなやっぱミミッキュってカスだわ <\br>	neg
 アニメミミッキュ「いや全然」 <\br>	pos
 ファイアロー1匹で虫と草と格闘がほぼ絶滅したからね。  ミミッキュよりもっともっとひどかった。 <\br>	neu
 ナットレイでミミッキュに勝てるみたいな風潮   無理なんだよなぁ... <\br>	neg
 ミミッキュ潰すために肝っ玉ガルーラ起用するかなマジで <\br>	pos
 ミミッキュ壊れとか言ってる奴のほうが何も考えてない馬鹿くさいけどな  俺はミミッキュが壊れてるなんて思ったこと一度もないわ  何でもかんでもすぐ壊れ壊れ言うほうが思考停止してる馬鹿 <\br>	neg
 ミミッキュ良いなぁ  早く育てたい <\br>	pos
 そういや身代わりミミッキュって見ないけどあいつの身代わり殴ったら先に化けの皮発動すんのか？ <\br>	neu
